111111111111111111111111111111111111111
100000000000000000000000000000000000001
100000000000000000000000000000000000001
100000000000000000000000000000000000001
100000000000000000000000000000000000001
000000000000000000000000000000000000001
000000000000000000000000000000000000001
000000000000000000000000000000000000001
111111111100000000000000000000000000001
100000000011000011000000000000000000001
100000000000000000000000000000000000001
100000000000000000001100000000000000001
100000000000000000000000000000000000001
100000000000000000000000000011100000001
100000000000000000000000000000000000001
100000000000000000000000000000000000001
000000000000000000000000100000000000001
000000000000000000000000000000000000001
000000000000000000000000000000000000001
111111111000001111111111111111110000001
111111111000001111111111111111110000001
111111111000001111111111111111110000001