111111111111111111111111111111111111111
100000000000000000000000000000000000001
100000000000000000000000000000000000001
100000000000000000000000000000000000001
100000000000000000000000000000000000001
100000000000000000000000000000000000001
100000000000000000000000000000000000001
100000000000000000000000000000000000001
100000000000000000000000000000000000001
100000000000000000000000000000000000001
100000000000000000000000000000000000001
100000000000000000000000000000000000001
100000000000000000000000000000000000001
100000000000000000000000000000000000001
111100000000000000000000000000000000001
111100000000000000000000000000000000001
111111000000000000000000001100000000000
111111000000000000000000001100000000000
111111000110000000000000001100000000000
111111111111111111111111111111111111111
111111111111111111111111111111111111111
111111111111111111111111111111111111111