111111111111111111111111111111111111111
100000000000000000000000000000000000001
100000000000000000000000000000000000001
100000000000000000000000000000000000001
100000000000000000000000000000000000001
100000000000000000000000000000000000001
100000000000000000000000000000000000001
100000000000000000000000000000000000001
100000000000000000000000000000000000001
000000000000000000000000000000000000001
000000000000000000000000000000000011001
000000000000000000000000000000000000001
111111111111111111111111111000000000001
100000000000000000000000000000110000001
100000000000000000000000000000000000001
100000000000000000000000000000000001101
000000000000000000000000000000000000001
000000000000000000000000000000011000001
000000000000000000000000000000000000001
111111111111111111111111111110000000001
111111111111111111111111111110000000001
111111111111111111111111111110000000001