111111111111111111111111111111111111111
100000000000000000000000000000000000001
100000000000000000000000000000000000001
100000000000000000000000000000000000001
100000000000000000000000000000000000001
100000000000000000000000000000000000001
100000000000000000000000000000000000001
100000000000000000000000000000000000001
100000000000000000000000000000000000001
100000000011111111111111111110000000001
100000000000000000000000000000000000001
100000000000000000000000000000000000001
100000000000000000000000000000000000001
100000000000000000000000000000000000001
100000000011111111111111111110000000001
100000000000000000000000000000000000001
100000000000000000000000000001100000000
100000000000000000000000000000000000000
101100010000011100011100000000000000000
111111111111111111111111111111111111111
111111111111111111111111111111111111111
111111111111111111111111111111111111111