1111111111111111111111111111
1000000000000000000000000001
1000000000000000000000000001
1000000000000000000000000001
1000000000000000000000000001
1000000000000000000000000001
0000000000000000000000000001
0000000000000000000000000001
0000000000000000000000000001
1111000000000000000000000001
1000000000000000000000000001
1000000000000000000000000001
1000000000000000000000000000
1000000000110000000000000000
1000000001010000000000000000
1000000010010000000000001111
1000000000000000000000000001
1000000000000000000000000001
1000000000000000000000000001
1000000000000000001100000001
1000000000000000000000000001
1000000000000000000000000001
1000000000000000000000000001
1000001111100000000000000001
1000000000000000000000000001
1000000000000000000000000001
1000000000000000000000000001
1000000000000000000000000001
0000000000000000000000000001
0000000000000000000000000001
0000000000000000000000000001
1111000000000000000000000001
1000000000000000000000000001
1000000000000000000000000001
1000000000000000000000000001
1000000000000000000000000001
1000000000000000000000000001
1000000000000000000000000001
1000000000000000000000000001
1000000000000000000000000001
1000000000000000000000000001
1000000000000000000000000001
1000000000000000000000000001
1000000000000000000000000001
1000000000000000000000000001
1000000000000000000000000001
1000000000000000000000000001
1000000000000000000000000001
1000000000000000000000000001
1111111111111111111111111111