111111111111111111111111111111111111111
100000000000000000000000000000000000001
100000000000000000000000000000000000001
100000000000000000000000000000000000001
100000000000000000000000000000000000001
100000000000000000000000000000000000001
100000000000000000000000000000000000001
100000000000000000000000000000000000001
100000000000000000000000000000000000001
100000000000000000000000000000000000001
100000000000000000000000000000000000001
100000000000000000111000000000000000001
100000000000000000001100000000000000001
110000000000000000000100000000000000001
111000000000000000000111000000000000001
111110000000000000000001000000000000001
111111000000000000000000001110000000000
111111100000000000000000000000000000000
111111110000000000000000000000000000000
111111111111111111111111111111111111111
111111111111111111111111111111111111111
111111111111111111111111111111111111111